{
    "0x0": "0x2ff2cc25",
    "0x20": "0x0000000000000000000000000000000000000000000000000000000000000001",
    "0x40": "0x0000000000000000000000000000000000000000000000000000000000000002",
    "0x60": "0x0000000000000000000000000000000000000000000000000000000000000003",
    "0x80": "0x0000000000000000000000000000000000000000000000000000000000000004",
    "0xa0": "0x0000000000000000000000000000000000000000000000000000000000000005",
    "0xc0": "0x0000000000000000000000000000000000000000000000000000000000000006",
    "0xe0": "0x0000000000000000000000000000000000000000000000000000000000000007",
    "0x100": "0x0000000000000000000000000000000000000000000000000000000000000008",
    "0x120": "0x0000000000000000000000000000000000000000000000000000000000000008",
    "0x140": "0x000000000000000000000000000000000000000000000000000000000000000a",
    "0x160": "0x000000000000000000000000000000000000000000000000000000000000000b",
    "0x180": "0x000000000000000000000000000000000000000000000000000000000000000c"
}